#############
#           #
#           #
#   1       #
#   #####   #
#   #   #   #
#   #   #   #
#   #   #   #
#   #####   #
#       2   #
#           #
#           #
#############
