#############
#           #
# ##        #
# ##        #
#    1      #
#    ###    #
#    ###    #
#    ###    #
#      2    #
#        ## #
#        ## #
#           #
#############
