#######
#1    #
#     #
#     #
#     #
#    2#
#######
